# Room 1
---------------
-----------...-
-----------.~.-
---.......-.~.-
---..----.-.~.-
---..----.-...-
---..---..-...-
---------.--.--
---------......
---------.-----
# Legend
* - : Wall
* . : Floor
* ~ : Water
